

SO ./textures/xpm/south_rock.xpm
EA ./textures/xpm/east_rock.xpm



NO  ./textures/xpm/north_rock.xpm

   WE   ./textures/xpm/west_rock.xpm



C             0,0,255
F             21,32,11


    11111   111111
    1111111111
    11000S001
    1110111111
    11111   1111111111111
