 SO      ./textures/xpm/south_rock.xpm
EA         ./textures/xpm/east_rock.xpm
NO  ./textures/xpm/north_rock.xpm
C             80,170,230

   WE   ./textures/xpm/west_rock.xpm


         F 170,100,30

1111
1001111111111
1100100000001
1000010000001
10001010000011
11000001S001
100000100001
10000101010011
1000000000001
10000001000011
1111111111111
