
jsdjhg


44111111111
1001
111111111111
