
jsdjhg


11111111
1S000001
11111111111
