

SO ./textures/xpm/south_rock.xpm
EA ./textures/xpm/east_rock.xpm



NO  ./textures/xpm/north_rock.xpm

   WE   ./textures/xpm/west_rock.xpm



C             0,0,300
F             21,32,11


    11111   11S111
    1111111111
    110000001
    1111111111
    11111   1111111111111
            









            